............................................................................................
...................................#........................................................
............................................................................................
............................................................................................
............................................................................................
############################################################################################
