...........................................
...........................................
...........................................
...........................................
...........................................
...........................................
...........................................
...........................................
...........................................
...........................................
...........................................
...........................................
.............*.............................
............*..............................
...........*...............................
###########################################